*********************************
*   *               *     *     *
* * * * * ** *** **   *** * *** *
* *     *         * *         * *
* ** ** ** ** *** * *** * ***   *
*                       *     * *
** ** * *** *** * * *** ** ** * *
*   *           *               *
* *   * * *** * * * *   ** ** * *
*   * * *             *     * * *
* * * * * *** * * * * ** **   * *
* *           *       *     *   *
* *** ** ** * *** *** ** ** *** *
*         * *                 * *
*** * *** * *** * * * * * ***   *
*   * *         * * * * *   * * *
* *   * * *** * *   *     * * * *
*   *       * *   *   * *   *   *
*** ** **** * ** ** * * *** *** *
*                               *
* * ***** * * ** **   * *** *** *
* *     * * * *     * * *       *
* * ***       * *** * * * *** * *
*     * * * *     *         * * *
* ***   * *   ***   * * *** *   *
*   * *     *   * * *   *     * *
*** * * *** ***   * *** *** * * *
*               *           *  L*
*********************************