*****************************************
*     *   *       *           *         *
* * * *   * *   * * ** ** * *   *** *** *
* *   * *       *         *   *       * *
* * *   * ** ** * ** ** * * * *** ***   *
*     * *     *         *           * * *
* ***   ** **   * *** * * * * * *** * * *
*     *     * *       *     *     *     *
*** * ** **   * *** * * *** ** ** * *** *
*   *     * *     *                 *   *
* *** ***   * * * * * * *** ** ** *   ***
*         *     *         *       * *   *
* ** ** * ** ** * *** * * ** ** * * * * *
*                   *   *             * *
* * * * ** ** * * *   * ** ** * * * * * *
* * *         *   * *               *   *
* * * ** ** * * *   * ** ** * * * * *   *
*     *           *         *     *   * *
* *** ** ** *** * * ** ** * * *** * *   *
*               *   *           *     * *
*** ** ** *** * *** * *** * * * *   * * *
*       *   *     *     *     *     *   *
* ** ** * *   *** ** ** * *** * ***   * *
*     *   * * *           *         *   *
* * * * *   * ** ** * * * * *** * *** ***
* * *   * *         * * *       *       *
* * * * *   *** ***     * * * * *** *** *
*         *         * *     *           *
* * * * * *** *** *   * *** * *** *** * *
*   *             * *   *              L*
*****************************************